8 8 8 8 8 8 8 8 8 8 8
8 8 8 r r 0 r 0 8 8 8
8 8 r r t 6 0 r 8 8 8
8 8 r 6 0 0 0 6 r 8 8
8 8 0 0 0 a 0 0 v 8 8
8 8 8 0 0 0 0 0 8 8 8
8 8 8 8 0 0 1 8 8 8 8

