v 0 0 0 0 0 0 0 0 0 v
4 0 0 0 0 0 0 0 0 0 0
0 t 0 0 0 0 0 0 0 0 0
0 0 0 0 0 0 0 0 0 0 0
0 0 0 0 0 0 0 0 0 0 f
0 0 f 0 0 0 0 0 0 f p
v 0 0 0 0 0 0 0 0 0 v
