8 8 8 8 8 8 8 8 8 8 8
r 8 8 8 8 8 8 8 8 t r
p r 8 8 8 8 8 8 r 0 0
0 0 1 q c v r 0 0 0 0
0 0 c f 0 r 0 0 0 0 0
0 t 8 8 8 8 8 8 8 t r
r 8 8 8 8 8 8 8 8 8 8
