r 0 r r 0 v 0 0 0 t v
1 0 0 0 v 0 t v 0 0 0
0 t 0 0 0 q 0 0 0 0 0
0 0 0 0 q f q 0 0 0 0
0 0 0 0 0 0 0 0 0 f v
0 0 q f q 0 0 0 f p f
r t 0 q 0 0 t 0 0 f 0
