v 0 0 0 0 0 0 0 0 0 v
4 t 0 0 0 0 0 0 0 0 0
0 0 0 0 0 0 0 0 0 0 0
0 0 0 0 0 f 0 0 0 0 0
0 0 0 0 0 0 0 r 0 0 f
0 0 0 0 0 0 0 0 0 f p
v 0 0 0 0 0 0 0 0 0 v
