0 0 1 0 0 0 0 0 0 0 1
0 0 0 0 0 0 0 1 1 1 1
0 0 0 0 0 0 1 1 1 1 1
0 0 0 0 0 0 0 0 0 0 p
0 0 0 t 0 0 r 0 0 0 1
0 0 0 f a 0 0 0 0 r 0
0 0 0 0 0 0 0 0 r 1 r

