1 0 0 0 0 0 0 0 0 0 1
1 0 0 0 2 0 2 0 0 0 1
1 0 0 1 0 0 0 0 0 0 1
1 0 0 0 0 0 0 0 0 p 0
1 0 0 r 0 0 r 0 0 0 0
1 0 0 f 0 0 0 0 0 0 0
1 0 0 0 0 0 0 0 0 0 0

